11111111111111111111111111111111111111111111111111
11111111111111111111111111111111111111111111111111
11111111111111111111111111111111111111111111111111
11100111111111111111111111111111111111111111111111
11100111111111111111111111111111111111111111111111
11100111111111111111111111111111111111100001111111
11100000000000000000000011111111111111101101111111
11100000000000000000000010000000011111101101111111
11100111000011000001110010111110011100001101111111
11100111000011000001110010111010011101101101111111
11100111001100110001110010000010010000101101111111
11100111001100110001110011111110010110101101111111
11100111000000000001110000000000010000101101111111
11100111000000000001110000000000010000101101101111
11100111111111111111110011111001110110101100001111
11100111111111111111110011111001110000101101101111
11100000000000000011110011111001110000101101101111
11100000000000000011110011111001110000101101101111
11111111111111110011110011111001110000101101101111
11111000000000000000000000011001111001101101101111
11111000000000000011111110011001111111101101101111
11111001111111110011111110000000000000000000001111
11111001111111110011111110000000000000000000111111
11111001111111110011111110011111101100000001111111
11111000000011110000011110011111101110000011111111
11111000000011100000001110011001101111000111111111
11111001110011000000000110011011101111101111111111
11111001110011000000000110011011101111000111111111
11111001110011000111000110011011101110000011111111
11111001110011000111000110011000001100000001111111
11111001110011000111000110011001111100000001111111
11111001110011000000000110011000000000000001111111
11111001110011000000000110011001111111111111111111
11111001110011100000001110011001111111111111111111
11111001110011110000011110011001100000000001111111
11111001110011111111111110011101101111111101111111
11111000000000000000000000001101000011000101111111
11111000000000000000000000001101000010000101111111
11111001111111111111111111001100000010000101111111
11111001100000000000000000000111000000000101111111
11100001101111111111111111000111000000000101111111
11100001101111111111111111000111100000001101111111
11100111100000000011111111000111111111111101111111
11100111111111111110000000000000000000000001111111
11100011111110000000000000111111111111111111111111
11100000111000000000000000111111111111111111111111
11100000000000000001111111111111111111111111111111
11111111111111111111111111111111111111111111111111
11111111111111111111111111111111111111111111111111
11111111111111111111111111111111111111111111111111