11111111111111111111111111111111111111111111111111
11111111111111111111111111111111111111111111111111
11111111111111111111111111111111111111111111111111
11111111111111111111111111111111111111111111111111
11110000111000000000000000111111111111111111111111
11110000010001000111111110011111111100000111111111
11110000000011100000100010001111100000000111111111
11110011111111111100100010000111000110000011111111
11110010000000000100100011000000000110001001111111
11111011110100010100101011100000000000001100111111
11111000110101010110100011110000111100000000111111
11111110110101010010100010000000000111110000111111
11111110110101010010100010011100000000011111111111
11111110000101011010101011110000100000010011111111
11111110111111010010100011100001101110010011111111
11111110100000010110100011100011001110011000111111
11111110101111110010100011000010000110001000011111
11111110100000010010101011000010000111101000011111
11111110101111011010100011000011000000101000011111
11111110000001001010100011000111111110101000111111
11111110101111111010110111100111000000101000111111
11111110101111100010000000111110000111101000111111
11111111100001100110000000110010001100001000111111
11111111111111101110000000000010001101111010111111
11111111111111101111111111111111000101110010111111
11111111111111101110000000011111110100000110111111
11111111111111101110111111011111111111111110111111
11111111111111101000011111000000000000000000111111
11111111111111101000001110011111111100111111111111
11111111111111101100011110011111111100111111111111
11111111011111001111111000111111111100111111111111
11111110001111011111100011111111000000000000001111
11111110000000011110000111111100000000001000001111
11111100011111111100100011110000011000011100001111
11111100110001111000000001100001111000001001001111
11111100100000111100010001000111111000000011101111
11111110000000010110000100001111111000000001001111
11111111111100010010000001000111111001000000001111
11111110000000111000101111100011111011100001001111
11111110111111111100100011110011111001000011101111
11111110000001111110100011110011111000000001001111
11111110000011111111111011110001111000000000001111
11111111000000000000000011111000111000100001001111
11111111000111111111111111111100000001110011101111
11111111101111111111111111111110000000100001001111
11111111111111111111111111111111111000000000001111
11111111111111111111111111111111111111111111111111
11111111111111111111111111111111111111111111111111
11111111111111111111111111111111111111111111111111
11111111111111111111111111111111111111111111111111