1111111111111111111111111111111111111111111111111111111111111111111111111111111111111111111111111111111111111111111111111111
1000000000100000001000000001000000010000000100000000100000000010000000001000000001000000010000000100000000100000000000000001
1000000000100000001000000001000000010000000100000000100000000010000000001000000001000000010000000100000000100000000000000001
1000000000100000001000000001000000010000000100000000100000000010000000001000000001000000010000000100000000100000000000000001
1000000000100000001000000001000000010000000100000000100000000010000000001000000001000000010000000100000000111111001110011111
1000000000100000001000000001000000010000000100000000100000000010000000001000000001000000010000000100000000100000001000000001
1000000000100000001000000001000000010000000100000000100000000010000000001000000001000000010000000100000000100000001000000001
1000000000100000001000000001000000010000000100000000100000000010000000001000000001000000010000000100000000100000001000000001
1000000000100000001000000001000000010000000100000000100000000010000000001000000001000000010000000100000000100000001000000001
1000000000100000001000000001000000010000000100000000100000000010000000001000000001000000010000000100000000100000001000000001
1000000000100000001000000001000000010000000100000000100000000010000000001000000001000000010000000100000000100000001000000001
1000000000100000001000000001000000010000000100000000100000000010000000001000000001000000010000000100000000100000001000000001
1000000000100000001000000001000000010000000100000000100000000010000000001000000001000000010000000100000000100000001000000001
1000000000100000001000000001000000010000000100000000100000000010000000001000000001000000010000000100000000100000001000000001
1000000000100000001000000001000000010000000100000000100000000010000000001000000001001111110000000100000000100000001000000001
1000000000100000001000000001000000010000000100000000100000000010000000001000000001001000010000000100000000100000001000000001
1000000000100100001000000001001111111111100100000000100000000010000000001000000001001000011111100100000000100000001000000001
1000000000100111111000000001001000010000100111100111100000000010000000001111001111001000010000100100000000100000001000000001
1000000000100100001000000001001000010000000000000000000000000010000000000000000000001000010000100100000000100000001000000001
1111110011100000001111100111001000010000000000000000000000000010000000000000000000000000010000100110011111111111001000000001
1000000000000000001000000000000000010000100000000000100000000010000000001000000000000000010000000000000000100001001000000001
1000000000000100001000000000000000011111100000000000100000000010000000001000000000001111110000000000000000100000001000000001
1000000000000100001000000000001000010000000000000000100000000010000000001000000000000000010000100000000000100000001000000001
1000000000000100001000000000001000010000000000000000100000000010000000001000000000000000010000100000000000100001001000000001
1000000000000111111111111100111111111111111110011111111111111111111111111111100111111111111111111001111111111111001110011111
1000000000000000000000000000000000000000000000000000000000000000000000000000000000000000000000000000000000000000000000000001
11111111111111111111111111111111111111111111111111111111111111111111111111111111111111111111111111111111111111111111111111111