11111111111111111111111111111111111111111111111111
11111111111111111111111111111111111111111111111111
11111111111111111111111111111111111111111111111111
11111111111111111000111111111111100000000001111111
11111111111111000000001111111111000000000000111111
11111001111110011111100011111110111011001011011111
11111001111100110000111001111100100010101010101111
11111001111001100000001100111100111010101010101111
11111001110011001111100110011100100010101010101111
11111001110110011000110011011100111010011011001111
11111001100100110000011001001100000000000000001111
11111001100101100111001101101100111110011111001111
11111001101101001100000100101110000000000000011111
11111001101001011000000100101110111110011111011111
11111001101011010000001100101110000000000000011111
11111001101011010000011001101110111110011111011111
11111001101011011100110011001110000000000000011111
11111001101001000110000110011111011110011110111111
11111001101101100011101100111111000000000000111111
11111001100100111000111001111111011110011110111111
11111001100110001110000011001111000000000000111111
11111001100111100011001110000111101110011101111111
11111001100011111011111100110111100000000001111111
11111001100011111000000001100111101110011101111111
11111001100001111111111111100111100000000001111111
11111001100000000000111111000111100110011001111111
11111001110000000000011110000111110000000011111111
11111001111111111100011110000111110110011011111111
11111001100000000110011100000111110000000011111111
11111001101111110110011000001111110110011011111111
11111001101000000110011000011111110000000011111111
11111001101011111110010000011111111010010111111111
11111001101000000110010000111111111000000111111111
11111000001111110110010000111111111010010111111111
11111111111000000110010000111111111000000111111111
11111111111011111110011000111111111100001111111111
11111101110001111110011000011111111100001111111111
11111000100000111100011100001111111100001111111111
11111000100000011000011100000111111100001111111111
11111000100000010000011110000111111100001111111111
11111101110111111110011110000011111110011111111111
11111100000000000010011111000000111110011111111111
11111101111111111010011111000000001100011111111111
11111100001100001010011111100000000000011111111111
11111110011110000000111111110000000000111111111111
11111111111111111111111111111111111111111111111111
11111111111111111111111111111111111111111111111111
11111111111111111111111111111111111111111111111111
11111111111111111111111111111111111111111111111111
11111111111111111111111111111111111111111111111111