               1111111111111111111111111111
           111111000000000000000000000000111111
        111111111000000000000000000000000111111111
    11111111111110000000000000000000000001111111111111
1111111111111111100000000000000000000000011111111111111111
1111111111111111100000000000000000000000011111111111111111
    11111111111110000000000000000000000001111111111111
        111111111000000000000000000000000111111111
           111111000000000000000000000000111111
               1111111111111111111111111111