11111111111111111111
10001111000000010001
10100001011011000111
10111100000010010001
10000111110111011101
11110000010001110001
11000111011100000111
11011101010111111101
10010100010000000001
10110001000111101101
10000101011101000101
11110111001000010001
10000100011101011111
10111110110101000101
10010000100001110001
10110101111011100101
10000100001000101101
10111101111110101001
10100000000010000011
11111111111111111111