               1111111111111111111111111111
           111111000000000000000000000000111111
        111111111001000000111111010000000111111111
    11111111111110010000001000010100000001111111111111
1111111111111111100100000010000101000000011111111111111111
1111111111111111100100000010000101000000011111111111111111
    11111111111110010000001000010100000001111111111111
        111111111001111110111111011111100111111111
           111111000000000000000000000000111111
               1111111111111111111111111111