1111111111111111111111111111111111111111111111111
1111111111111111111111111111111111111111111111111
1111111111111111111111111111111111111111111111111
1110000000000000011100000000000000000000000000111
1110000000000000011100000000000000000000000000111
1110000000000000011100000000000000000000000000111
1110000000000000011100000000000000001111100000111
1110000000000000011100000001110000001111100000111
1110000000000000011100000001110000001111100000111
1110000000000000011100000001110000001111100000111
1110000000000000011100000001110000001111100000111
1110000000000000011100000001110000001111100000111
1110000000000000011100000001110000001111100000111
1110000000000000000000000001110000001111100000111
1110000000000000000000000001110000001111100000111
1110000000000000000000000001110000000000000000111
1110000000000000000000000001110000000000000000111
1110000000000000011100000001110000000000000000111
1111111111111111111111111111111111111111111111111
1111111111111111111111111111111111111111111111111
1111111111111111111111111111111111111111111111111